1000011111000002
1000000001000022
1000000001000002
1111000011000000
0000000000000000
0000000000000000
0000002222000000
0000022222200000
0000022222200000
0000002222000000
0000000000000000
0000000000000000